89000008
88888808
88888808
80008808
80800808
80800008
80880088
00001888